书籍是人类进步的阶梯。	——高尔基
书籍是全世界的营养品。	——莎士比亚
书籍是巨大的力量。	——列宁
读一本好书，像交了一个益友。	——臧克家
书籍是伟大的天才留给人类的遗产。	——爱迪生
书——人类发出的最美妙的声音。	——莱文
过去一切时代的精华尽在书中。	——卡莱尔
书籍——当代真正的大学。	——托马斯卡莱尔
书籍使人变得思想奔放。	——革拉特珂夫
书籍使人们成为宇宙的主人。	——巴甫连柯
读书越多，越感到腹中空虚。	——雪莱
我扑在书籍上，就好像饥饿的人扑在面包上。	——高尔基
各种蠢事，在每天阅读好书的影响下，仿佛烤在火上一样，渐渐熔化。	——雨果
生活里没有书籍，就好像没有阳光；智慧里没有书籍，就好像鸟儿没有翅膀。	——莎士比亚
生活在我们这个世界里，不读书就完全不可能了解人。	——高尔基
与其用华丽的外表来装饰自己，不如用知识武装自己。	——马克思
阅读使人充实，会谈使人敏捷，写作使人精确。	——培根
生活里没有书籍，就好像没有阳光；智慧里没有书籍，就好像鸟儿没有翅膀。	——莎士比亚
生活在我们这个世界里，不读书就完全不可能了解人。	——高尔基
读万卷书，行万里路。	——刘彝
读书百遍，其义自现。	——三国志
一日无书，百事荒芜。	——陈寿
读书破万卷，下笔如有神。	——杜甫
书如药也，善读之可以医愚。	——刘向
读书之法，在循序而渐进，熟读而精思。	——朱熹
读书使人心明眼亮。	——伏尔泰
读书之于头脑，好比运动之于身体。	——爱迪生
一个家庭中没有书籍，等于一间房子没有窗子。	——约翰森
读一本好书，象交了一个益友。	——臧克家
黑发不知勤学早，白首方悔读书迟。	——颜真卿
读书有三到，谓心到，眼到，口到。	——朱熹
书籍是青年人不可分离的生命伴侣和导师。	——高尔基
读一本好书，就是和许多高尚的人谈话。	——笛卡尔
光阴给我们经验，读书给我们知识。	——奥斯特洛夫斯基
不去读书就没有真正的教养，同时也不可能有什么鉴别力。	——赫尔岑
书籍是巨大的力量。	——列宁
人不能像走兽那样活着，应该追求知识和美德。	——但丁
读书如饭，善吃饭者长精神，不善吃者生疾病。	——章学诚
理想的书籍，是智慧的钥匙。	——列夫托尔斯泰
和书籍生活在一起，永远不会叹气。	——罗曼·罗兰
在你渴望时，它前来给予详细指教，但是从不纠缠不休。	——比切
书籍是人类进步的阶梯，终生的伴侣，最诚挚的朋友。	——高尔基
